7, 24, 20
F......................M
........................
........................
.XXXXXXXXXXXXXXXXXXXXXX.
.XXXXXXXXXXWWXXXXXXXXXX.
.XXXXXXXXXX..XXXXXXXXXX.
........................
