30, 30, 1000
W.W.W.W.W.W.W.W.W.W.W.W.W.W.W.
F.F.F.F.F.F.F.F.F.F.F.F.F.F.F.
M.M.M.M.M.M.M.M.M.M.M.M.M.M.M.
W.W.W.W.W.W.W.W.W.W.W.W.W.W.W.
M.M.M.M.M.M.M.M.M.M.M.M.M.M.M.
F.F.F.F.F.F.F.F.F.F.F.F.F.F.F.
W.W.W.W.W.W.W.W.W.W.W.W.W.W.W.
F.F.F.F.F.F.F.F.F.F.F.F.F.F.F.
M.M.M.M.M.M.M.M.M.M.M.M.M.M.M.
W.W.W.W.W.W.W.W.W.W.W.W.W.W.W.
M.M.M.M.M.M.M.M.M.M.M.M.M.M.M.
F.F.F.F.F.F.F.F.F.F.F.F.F.F.F.
W.W.W.W.W.W.W.W.W.W.W.W.W.W.W.
F.F.F.F.F.F.F.F.F.F.F.F.F.F.F.
M.M.M.M.M.M.M.M.M.M.M.M.M.M.M.
W.W.W.W.W.W.W.W.W.W.W.W.W.W.W.
M.M.M.M.M.M.M.M.M.M.M.M.M.M.M.
F.F.F.F.F.F.F.F.F.F.F.F.F.F.F.
W.W.W.W.W.W.W.W.W.W.W.W.W.W.W.
F.F.F.F.F.F.F.F.F.F.F.F.F.F.F.
M.M.M.M.M.M.M.M.M.M.M.M.M.M.M.
W.W.W.W.W.W.W.W.W.W.W.W.W.W.W.
M.M.M.M.M.M.M.M.M.M.M.M.M.M.M.
F.F.F.F.F.F.F.F.F.F.F.F.F.F.F.
W.W.W.W.W.W.W.W.W.W.W.W.W.W.W.
F.F.F.F.F.F.F.F.F.F.F.F.F.F.F.
M.M.M.M.M.M.M.M.M.M.M.M.M.M.M.
W.W.W.W.W.W.W.W.W.W.W.W.W.W.W.
M.M.M.M.M.M.M.M.M.M.M.M.M.M.M.
..............................
